MAP: 12 18 3 3 270
1 1 1 1 1 1 1 1 1 1 2 2 2 1 1 1 1 1
1 ` 1 ` ` ` ` ` ` ` ` ` ` ` ` ` A 1
1 ` 1 1 1 1 1 1 1 ` 1 2 2 2 1 1 ` 1
1 ` ` ` ` 3 ` ` ` ` ` ` ` ` ` 1 ` 1
1 1 3 2 2 2 1 1 1 1 1 1 1 1 ` ` ` 1
1 ` ` ` ` ` ` ` ` ` ` ` ` 1 ` 1 ` 1
1 1 1 2 2 2 ` 1 1 1 1 1 ` 1 A 1 ` 1
1 A ` ` ` ` ` ` 1 1 ` ` ` 1 1 1 ` 1
1 1 1 ` 1 1 1 ` ` ` ` 1 ` ` ` ` ` 1
` ` 1 ` 1 ` 1 2 2 2 2 1 ` 1 1 1 ` 1
` ` 1 ` ` ` ` ` ` 1 A ` ` ` ` ` ` 6
` ` 1 1 1 1 1 1 1 1 1 1 1 1 1 1 1 1
